Timestamp;Card type;Transaction ID;Transaction Details;Credit INR;Debit INR;Previous Balance INR;New Balance INR
27/06/2019 14:20:00;Meal card;115713806530;SODEXO FOOD SOLUTIONS (I) PVT LTD;0.00;65.00;1591.00;1526.00
27/06/2019 11:43:57;Meal card;115715777246;SODEXO FOOD SOLUTIONS (I) PVT LTD;0.00;38.00;1629.00;1591.00
27/06/2019 09:37:52;Meal card;115710769258;SODEXO FOOD SOLUTIONS (I) PVT LTD;0.00;20.00;1649.00;1629.00
27/06/2019 09:29:12;Meal card;115713769003;SODEXO FOOD SOLUTIONS (I) PVT LTD;0.00;25.00;1674.00;1649.00
26/06/2019 16:40:40;Meal card;115710666673;SODEXO FOOD SOLUTIONS (I) PVT LTD;0.00;20.00;1694.00;1674.00
26/06/2019 09:59:09;Meal card;115785617184;SODEXO FOOD SOLUTIONS (I) PVT LTD;0.00;25.00;1719.00;1694.00
26/06/2019 09:32:00;Meal card;115710614804;SODEXO FOOD SOLUTIONS (I) PVT LTD;0.00;35.00;1754.00;1719.00
25/06/2019 17:43:27;Meal card;115715533085;SODEXO FOOD SOLUTIONS (I) PVT LTD;0.00;25.00;1779.00;1754.00
25/06/2019 12:55:05;Meal card;115713491052;SODEXO FOOD SOLUTIONS (I) PVT LTD;0.00;65.00;1844.00;1779.00
25/06/2019 09:42:43;Meal card;115715465296;SODEXO FOOD SOLUTIONS (I) PVT LTD;0.00;8.00;1852.00;1844.00
25/06/2019 09:39:10;Meal card;115711468116;SODEXO FOOD SOLUTIONS (I) PVT LTD;0.00;30.00;1882.00;1852.00
24/06/2019 15:30:56;Meal card;115710384165;SODEXO FOOD SOLUTIONS (I) PVT LTD;0.00;10.00;1892.00;1882.00
24/06/2019 15:27:32;Meal card;115708385093;SODEXO FOOD SOLUTIONS (I) PVT LTD;0.00;38.00;1930.00;1892.00
24/06/2019 13:21:18;Meal card;115710365347;SODEXO FOOD SOLUTIONS (I) PVT LTD;0.00;35.00;1965.00;1930.00
24/06/2019 11:16:56;Meal card;115715344714;SODEXO FOOD SOLUTIONS (I) PVT LTD;0.00;35.00;2000.00;1965.00
21/06/2019 13:53:57;Meal card;115713081555;CAPGEMINI TECHNOLOGY SERVICES INDIA LTD;2000.00;0.00;0.00;2000.00
26/12/2019 17:54:39;Meal card;140067182981;SODEXO FOOD SOLUTIONS (I) PVT LTD;0.00;50.00;1984.00;1934.00
26/12/2019 13:13:34;Meal card;140060154420;SODEXO FOOD SOLUTIONS (I) PVT LTD;0.00;35.00;2019.00;1984.00
26/12/2019 12:52:24;Meal card;140066150564;SODEXO FOOD SOLUTIONS (I) PVT LTD;0.00;94.00;2113.00;2019.00
24/12/2019 17:06:10;Meal card;139776620419;SODEXO FOOD SOLUTIONS (I) PVT LTD;0.00;160.00;2273.00;2113.00
24/12/2019 16:51:42;Meal card;139778615609;SODEXO FOOD SOLUTIONS (I) PVT LTD;0.00;15.00;2288.00;2273.00
24/12/2019 13:36:04;Meal card;139775596782;SODEXO FOOD SOLUTIONS (I) PVT LTD;0.00;35.00;2323.00;2288.00
24/12/2019 13:19:45;Meal card;139778592580;SODEXO FOOD SOLUTIONS (I) PVT LTD;0.00;75.00;2398.00;2323.00
24/12/2019 10:23:05;Meal card;139779572146;SODEXO FOOD SOLUTIONS (I) PVT LTD;0.00;25.00;2423.00;2398.00
20/12/2019 13:09:02;Meal card;139776096470;SODEXO FOOD SOLUTIONS (I) PVT LTD;0.00;70.00;2493.00;2423.00
20/12/2019 10:01:19;Meal card;139777077329;SODEXO FOOD SOLUTIONS (I) PVT LTD;0.00;15.00;2508.00;2493.00
20/12/2019 09:51:07;Meal card;139778076375;SODEXO FOOD SOLUTIONS (I) PVT LTD;0.00;20.00;2528.00;2508.00
19/12/2019 13:25:50;Meal card;139513078071;SODEXO FOOD SOLUTIONS (I) PVT LTD;0.00;80.00;2608.00;2528.00
19/12/2019 13:09:19;Meal card;138980964485;SODEXO FOOD SOLUTIONS (I) PVT LTD;0.00;75.00;2683.00;2608.00
19/12/2019 09:52:31;Meal card;138980944035;SODEXO FOOD SOLUTIONS (I) PVT LTD;0.00;30.00;2713.00;2683.00
18/12/2019 13:46:29;Meal card;138909853259;SODEXO FOOD SOLUTIONS (I) PVT LTD;0.00;35.00;2748.00;2713.00
18/12/2019 13:22:33;Meal card;138946843861;SODEXO FOOD SOLUTIONS (I) PVT LTD;0.00;84.00;2832.00;2748.00
18/12/2019 10:05:51;Meal card;138933820283;SODEXO FOOD SOLUTIONS (I) PVT LTD;0.00;25.00;2857.00;2832.00
17/12/2019 17:17:06;Meal card;138946730345;SODEXO FOOD SOLUTIONS (I) PVT LTD;0.00;10.00;2867.00;2857.00
17/12/2019 17:15:04;Meal card;138909732696;SODEXO FOOD SOLUTIONS (I) PVT LTD;0.00;30.00;2897.00;2867.00
17/12/2019 13:16:32;Meal card;138912695570;SODEXO FOOD SOLUTIONS (I) PVT LTD;0.00;75.00;2972.00;2897.00
17/12/2019 10:01:07;Meal card;138912672786;SODEXO FOOD SOLUTIONS (I) PVT LTD;0.00;35.00;3007.00;2972.00
17/12/2019 09:51:37;Meal card;138946670694;SODEXO FOOD SOLUTIONS (I) PVT LTD;0.00;20.00;3027.00;3007.00
16/12/2019 17:12:53;Meal card;139007522447;SODEXO FOOD SOLUTIONS (I) PVT LTD;0.00;35.00;3062.00;3027.00
16/12/2019 13:40:12;Meal card;138912491223;SODEXO FOOD SOLUTIONS (I) PVT LTD;0.00;35.00;3097.00;3062.00
16/12/2019 13:21:43;Meal card;138983486935;SODEXO FOOD SOLUTIONS (I) PVT LTD;0.00;75.00;3172.00;3097.00
16/12/2019 09:56:28;Meal card;138933459687;SODEXO FOOD SOLUTIONS (I) PVT LTD;0.00;20.00;3192.00;3172.00
13/12/2019 13:16:07;Meal card;138912167015;SODEXO FOOD SOLUTIONS (I) PVT LTD;0.00;60.00;3252.00;3192.00
13/12/2019 10:10:28;Meal card;138980142133;SODEXO FOOD SOLUTIONS (I) PVT LTD;0.00;35.00;3287.00;3252.00
13/12/2019 09:59:24;Meal card;138980141074;SODEXO FOOD SOLUTIONS (I) PVT LTD;0.00;20.00;3307.00;3287.00
11/12/2019 17:37:58;Meal card;138565491639;SODEXO FOOD SOLUTIONS (I) PVT LTD;0.00;80.00;3387.00;3307.00
11/12/2019 17:31:24;Meal card;138566488792;SODEXO FOOD SOLUTIONS (I) PVT LTD;0.00;35.00;3422.00;3387.00
11/12/2019 17:29:59;Meal card;138564489036;SODEXO FOOD SOLUTIONS (I) PVT LTD;0.00;35.00;3457.00;3422.00
11/12/2019 13:23:43;Meal card;138570441210;SODEXO FOOD SOLUTIONS (I) PVT LTD;0.00;65.00;3522.00;3457.00
11/12/2019 10:14:22;Meal card;138570405728;SODEXO FOOD SOLUTIONS (I) PVT LTD;0.00;25.00;3547.00;3522.00
10/12/2019 15:24:20;Meal card;138566176217;SODEXO FOOD SOLUTIONS (I) PVT LTD;0.00;38.00;3585.00;3547.00
10/12/2019 13:05:42;Meal card;138563150823;SODEXO FOOD SOLUTIONS (I) PVT LTD;0.00;35.00;3620.00;3585.00
10/12/2019 10:09:40;Meal card;138570130007;SODEXO FOOD SOLUTIONS (I) PVT LTD;0.00;20.00;3640.00;3620.00
09/12/2019 13:39:11;Meal card;138480609794;SODEXO FOOD SOLUTIONS (I) PVT LTD;0.00;35.00;3675.00;3640.00
09/12/2019 13:15:57;Meal card;138476602222;SODEXO FOOD SOLUTIONS (I) PVT LTD;0.00;92.00;3767.00;3675.00
09/12/2019 09:44:40;Meal card;138481562249;SODEXO FOOD SOLUTIONS (I) PVT LTD;0.00;35.00;3802.00;3767.00
06/12/2019 13:24:22;Meal card;138268396873;SODEXO FOOD SOLUTIONS (I) PVT LTD;0.00;75.00;3877.00;3802.00
06/12/2019 09:58:19;Meal card;138352221096;SODEXO FOOD SOLUTIONS (I) PVT LTD;0.00;35.00;3912.00;3877.00
06/12/2019 09:46:18;Meal card;138280354871;SODEXO FOOD SOLUTIONS (I) PVT LTD;0.00;20.00;3932.00;3912.00
04/12/2019 10:23:16;Meal card;1377621356830;SODEXO FOOD SOLUTIONS (I) PVT LTD;0.00;35.00;3967.00;3932.00
03/12/2019 17:08:16;Meal card;1377651158342;CAPGEMINI TECHNOLOGY SERVICES INDIA LTD;2000.00;0.00;1967.00;3967.00
03/12/2019 16:43:20;Meal card;1377641155852;SODEXO FOOD SOLUTIONS (I) PVT LTD;0.00;38.00;2005.00;1967.00
03/12/2019 13:09:04;Meal card;1377631119880;SODEXO FOOD SOLUTIONS (I) PVT LTD;0.00;35.00;2040.00;2005.00
03/12/2019 10:06:53;Meal card;1377651091606;SODEXO FOOD SOLUTIONS (I) PVT LTD;0.00;35.00;2075.00;2040.00
03/12/2019 09:59:17;Meal card;1377661086654;SODEXO FOOD SOLUTIONS (I) PVT LTD;0.00;20.00;2095.00;2075.00
02/12/2019 20:29:37;Meal card;137718970850;PATEL R MART;0.00;340.00;2435.00;2095.00
02/12/2019 16:46:49;Meal card;137764910334;SODEXO FOOD SOLUTIONS (I) PVT LTD;0.00;30.00;2465.00;2435.00
02/12/2019 13:44:09;Meal card;137766880237;SODEXO FOOD SOLUTIONS (I) PVT LTD;0.00;35.00;2500.00;2465.00
02/12/2019 13:33:44;Meal card;137765881345;SODEXO FOOD SOLUTIONS (I) PVT LTD;0.00;65.00;2565.00;2500.00
02/12/2019 10:04:59;Meal card;137766848767;SODEXO FOOD SOLUTIONS (I) PVT LTD;0.00;25.00;2590.00;2565.00
29/11/2019 13:47:30;Meal card;137765256678;SODEXO FOOD SOLUTIONS (I) PVT LTD;0.00;65.00;2655.00;2590.00
29/11/2019 09:53:22;Meal card;137719251201;SODEXO FOOD SOLUTIONS (I) PVT LTD;0.00;35.00;2690.00;2655.00
28/11/2019 15:57:22;Meal card;137719134243;SODEXO FOOD SOLUTIONS (I) PVT LTD;0.00;35.00;2725.00;2690.00
28/11/2019 12:59:29;Meal card;137718106208;SODEXO FOOD SOLUTIONS (I) PVT LTD;0.00;65.00;2790.00;2725.00
28/11/2019 09:57:54;Meal card;137763065635;SODEXO FOOD SOLUTIONS (I) PVT LTD;0.00;35.00;2825.00;2790.00
28/11/2019 09:47:41;Meal card;137765062931;SODEXO FOOD SOLUTIONS (I) PVT LTD;0.00;30.00;2855.00;2825.00
27/11/2019 10:24:39;Meal card;135758628996;SODEXO FOOD SOLUTIONS (I) PVT LTD;0.00;35.00;2890.00;2855.00
22/11/2019 15:30:13;Meal card;128029297421;SODEXO FOOD SOLUTIONS (I) PVT LTD;0.00;40.00;2930.00;2890.00
22/11/2019 10:14:57;Meal card;128031240224;SODEXO FOOD SOLUTIONS (I) PVT LTD;0.00;35.00;2965.00;2930.00
22/11/2019 10:06:04;Meal card;128027240076;SODEXO FOOD SOLUTIONS (I) PVT LTD;0.00;40.00;3005.00;2965.00
21/11/2019 09:53:58;Meal card;128009062603;SODEXO FOOD SOLUTIONS (I) PVT LTD;0.00;35.00;3040.00;3005.00
21/11/2019 09:44:49;Meal card;128027052723;SODEXO FOOD SOLUTIONS (I) PVT LTD;0.00;25.00;3065.00;3040.00
20/11/2019 17:13:57;Meal card;127764639172;SODEXO FOOD SOLUTIONS (I) PVT LTD;0.00;32.00;3097.00;3065.00
20/11/2019 17:05:48;Meal card;127763638811;SODEXO FOOD SOLUTIONS (I) PVT LTD;0.00;35.00;3132.00;3097.00
20/11/2019 13:43:10;Meal card;127762610788;SODEXO FOOD SOLUTIONS (I) PVT LTD;0.00;40.00;3172.00;3132.00
20/11/2019 13:22:44;Meal card;127762605153;SODEXO FOOD SOLUTIONS (I) PVT LTD;0.00;75.00;3247.00;3172.00
20/11/2019 10:37:46;Meal card;127767581574;SODEXO FOOD SOLUTIONS (I) PVT LTD;0.00;35.00;3282.00;3247.00
19/11/2019 16:55:02;Meal card;127764451368;SODEXO FOOD SOLUTIONS (I) PVT LTD;0.00;10.00;3292.00;3282.00
19/11/2019 16:53:48;Meal card;127763451781;SODEXO FOOD SOLUTIONS (I) PVT LTD;0.00;25.00;3317.00;3292.00
19/11/2019 11:30:32;Meal card;127871123119;SODEXO FOOD SOLUTIONS (I) PVT LTD;0.00;35.00;3352.00;3317.00
18/11/2019 13:15:30;Meal card;127771190793;SODEXO FOOD SOLUTIONS (I) PVT LTD;0.00;65.00;3417.00;3352.00
18/11/2019 11:02:22;Meal card;127767170090;SODEXO FOOD SOLUTIONS (I) PVT LTD;0.00;8.00;3425.00;3417.00
18/11/2019 11:00:28;Meal card;127763172365;SODEXO FOOD SOLUTIONS (I) PVT LTD;0.00;15.00;3440.00;3425.00
18/11/2019 09:43:08;Meal card;127761161584;SODEXO FOOD SOLUTIONS (I) PVT LTD;0.00;35.00;3475.00;3440.00
15/11/2019 13:23:31;Meal card;127624107804;SODEXO FOOD SOLUTIONS (I) PVT LTD;0.00;80.00;3555.00;3475.00
15/11/2019 10:00:44;Meal card;127606101124;SODEXO FOOD SOLUTIONS (I) PVT LTD;0.00;35.00;3590.00;3555.00
14/11/2019 10:33:01;Meal card;127436050875;SODEXO FOOD SOLUTIONS (I) PVT LTD;0.00;35.00;3625.00;3590.00
14/11/2019 10:26:16;Meal card;127436050102;SODEXO FOOD SOLUTIONS (I) PVT LTD;0.00;30.00;3655.00;3625.00
13/11/2019 10:27:53;Meal card;127111139219;SODEXO FOOD SOLUTIONS (I) PVT LTD;0.00;35.00;3690.00;3655.00
13/11/2019 10:21:06;Meal card;126934321886;SODEXO FOOD SOLUTIONS (I) PVT LTD;0.00;25.00;3715.00;3690.00
12/11/2019 13:23:47;Meal card;126927166272;SODEXO FOOD SOLUTIONS (I) PVT LTD;0.00;35.00;3750.00;3715.00
12/11/2019 13:08:11;Meal card;126940161631;SODEXO FOOD SOLUTIONS (I) PVT LTD;0.00;65.00;3815.00;3750.00
12/11/2019 10:16:43;Meal card;126943141625;SODEXO FOOD SOLUTIONS (I) PVT LTD;0.00;25.00;3840.00;3815.00
11/11/2019 13:06:43;Meal card;126943016834;SODEXO FOOD SOLUTIONS (I) PVT LTD;0.00;65.00;3905.00;3840.00
11/11/2019 10:27:34;Meal card;126895339116;SODEXO FOOD SOLUTIONS (I) PVT LTD;0.00;20.00;3925.00;3905.00
08/11/2019 10:59:53;Meal card;125027440603;SODEXO FOOD SOLUTIONS (I) PVT LTD;0.00;35.00;3960.00;3925.00
08/11/2019 10:53:57;Meal card;125780440029;SODEXO FOOD SOLUTIONS (I) PVT LTD;0.00;30.00;3990.00;3960.00
07/11/2019 16:48:30;Meal card;125011268559;SODEXO FOOD SOLUTIONS (I) PVT LTD;0.00;38.00;4028.00;3990.00
07/11/2019 11:29:44;Meal card;125025204126;SODEXO FOOD SOLUTIONS (I) PVT LTD;0.00;10.00;4038.00;4028.00
07/11/2019 10:04:22;Meal card;125011192035;SODEXO FOOD SOLUTIONS (I) PVT LTD;0.00;35.00;4073.00;4038.00
06/11/2019 17:06:29;Meal card;125014003634;SODEXO FOOD SOLUTIONS (I) PVT LTD;65.00;0.00;4008.00;4073.00
06/11/2019 15:03:31;Meal card;125011027698;SODEXO FOOD SOLUTIONS (I) PVT LTD;0.00;15.00;4023.00;4008.00
06/11/2019 15:02:29;Meal card;125009027438;SODEXO FOOD SOLUTIONS (I) PVT LTD;0.00;15.00;4038.00;4023.00
06/11/2019 13:26:56;Meal card;125027006858;SODEXO FOOD SOLUTIONS (I) PVT LTD;0.00;35.00;4073.00;4038.00
06/11/2019 13:13:12;Meal card;125014003731;SODEXO FOOD SOLUTIONS (I) PVT LTD;0.00;65.00;4138.00;4073.00
06/11/2019 13:12:58;Meal card;125014003634;SODEXO FOOD SOLUTIONS (I) PVT LTD;0.00;65.00;4203.00;4138.00
06/11/2019 10:27:16;Meal card;1242091431560;SODEXO FOOD SOLUTIONS (I) PVT LTD;0.00;10.00;4213.00;4203.00
06/11/2019 10:15:17;Meal card;1242131423307;SODEXO FOOD SOLUTIONS (I) PVT LTD;0.00;25.00;4238.00;4213.00
05/11/2019 17:37:01;Meal card;1242131289530;SODEXO FOOD SOLUTIONS (I) PVT LTD;0.00;35.00;4273.00;4238.00
05/11/2019 16:28:31;Meal card;1242091281757;CAPGEMINI TECHNOLOGY SERVICES INDIA LTD;2000.00;0.00;2273.00;4273.00
05/11/2019 13:04:23;Meal card;1242231228412;SODEXO FOOD SOLUTIONS (I) PVT LTD;0.00;65.00;2338.00;2273.00
05/11/2019 09:56:04;Meal card;1242071209902;SODEXO FOOD SOLUTIONS (I) PVT LTD;0.00;35.00;2373.00;2338.00
05/11/2019 09:47:29;Meal card;1242111207177;SODEXO FOOD SOLUTIONS (I) PVT LTD;0.00;20.00;2393.00;2373.00
04/11/2019 16:13:02;Meal card;1242071074562;SODEXO FOOD SOLUTIONS (I) PVT LTD;0.00;35.00;2428.00;2393.00
04/11/2019 12:55:57;Meal card;1242111028379;SODEXO FOOD SOLUTIONS (I) PVT LTD;0.00;75.00;2503.00;2428.00
04/11/2019 09:57:52;Meal card;1242071000598;SODEXO FOOD SOLUTIONS (I) PVT LTD;0.00;35.00;2538.00;2503.00
01/11/2019 17:07:46;Meal card;124223635140;SODEXO FOOD SOLUTIONS (I) PVT LTD;0.00;10.00;2548.00;2538.00
01/11/2019 17:02:14;Meal card;124213638709;SODEXO FOOD SOLUTIONS (I) PVT LTD;0.00;20.00;2568.00;2548.00
01/11/2019 13:12:31;Meal card;124208593806;SODEXO FOOD SOLUTIONS (I) PVT LTD;0.00;75.00;2643.00;2568.00
01/11/2019 10:24:32;Meal card;124209568368;SODEXO FOOD SOLUTIONS (I) PVT LTD;0.00;10.00;2653.00;2643.00
01/11/2019 10:12:52;Meal card;124209567179;SODEXO FOOD SOLUTIONS (I) PVT LTD;0.00;30.00;2683.00;2653.00
31/10/2019 13:06:17;Meal card;124209374989;SODEXO FOOD SOLUTIONS (I) PVT LTD;0.00;35.00;2718.00;2683.00
31/10/2019 12:53:28;Meal card;124213369208;SODEXO FOOD SOLUTIONS (I) PVT LTD;0.00;65.00;2783.00;2718.00
31/10/2019 10:16:27;Meal card;124213348742;SODEXO FOOD SOLUTIONS (I) PVT LTD;0.00;10.00;2793.00;2783.00
31/10/2019 10:07:23;Meal card;124211349519;SODEXO FOOD SOLUTIONS (I) PVT LTD;0.00;30.00;2823.00;2793.00
30/10/2019 17:17:16;Meal card;124209238631;SODEXO FOOD SOLUTIONS (I) PVT LTD;0.00;40.00;2863.00;2823.00
30/10/2019 17:05:18;Meal card;124209236482;SODEXO FOOD SOLUTIONS (I) PVT LTD;0.00;10.00;2873.00;2863.00
30/10/2019 16:54:31;Meal card;124215233525;SODEXO FOOD SOLUTIONS (I) PVT LTD;0.00;50.00;2923.00;2873.00
30/10/2019 13:05:16;Meal card;124223189928;SODEXO FOOD SOLUTIONS (I) PVT LTD;0.00;70.00;2993.00;2923.00
30/10/2019 10:17:31;Meal card;124207175402;SODEXO FOOD SOLUTIONS (I) PVT LTD;0.00;10.00;3003.00;2993.00
30/10/2019 10:08:05;Meal card;124215173896;SODEXO FOOD SOLUTIONS (I) PVT LTD;0.00;20.00;3023.00;3003.00
23/10/2019 13:39:59;Meal card;1233191187309;SODEXO FOOD SOLUTIONS (I) PVT LTD;0.00;20.00;3043.00;3023.00
23/10/2019 13:28:20;Meal card;1233171185099;SODEXO FOOD SOLUTIONS (I) PVT LTD;0.00;35.00;3078.00;3043.00
23/10/2019 10:26:41;Meal card;1233161162856;SODEXO FOOD SOLUTIONS (I) PVT LTD;0.00;10.00;3088.00;3078.00
23/10/2019 10:26:16;Meal card;1233191160272;SODEXO FOOD SOLUTIONS (I) PVT LTD;0.00;15.00;3103.00;3088.00
23/10/2019 10:19:21;Meal card;1233161162133;SODEXO FOOD SOLUTIONS (I) PVT LTD;0.00;30.00;3133.00;3103.00
22/10/2019 15:40:07;Meal card;1233191035639;SODEXO FOOD SOLUTIONS (I) PVT LTD;0.00;15.00;3148.00;3133.00
22/10/2019 15:39:32;Meal card;1233161037968;SODEXO FOOD SOLUTIONS (I) PVT LTD;0.00;10.00;3158.00;3148.00
22/10/2019 10:21:17;Meal card;123460969285;SODEXO FOOD SOLUTIONS (I) PVT LTD;0.00;35.00;3193.00;3158.00
16/10/2019 17:01:17;Meal card;1230354196867;SODEXO FOOD SOLUTIONS (I) PVT LTD;0.00;10.00;3203.00;3193.00
16/10/2019 16:56:34;Meal card;1229994194338;SODEXO FOOD SOLUTIONS (I) PVT LTD;0.00;20.00;3223.00;3203.00
16/10/2019 13:09:45;Meal card;1228394146501;SODEXO FOOD SOLUTIONS (I) PVT LTD;0.00;65.00;3288.00;3223.00
16/10/2019 10:42:28;Meal card;1220944119017;SODEXO FOOD SOLUTIONS (I) PVT LTD;0.00;20.00;3308.00;3288.00
16/10/2019 10:29:27;Meal card;1221224090981;SODEXO FOOD SOLUTIONS (I) PVT LTD;0.00;38.00;3346.00;3308.00
15/10/2019 13:22:26;Meal card;1230353878031;SODEXO FOOD SOLUTIONS (I) PVT LTD;0.00;65.00;3411.00;3346.00
15/10/2019 10:12:00;Meal card;1230353841350;SODEXO FOOD SOLUTIONS (I) PVT LTD;0.00;10.00;3421.00;3411.00
15/10/2019 10:00:16;Meal card;1220943838451;SODEXO FOOD SOLUTIONS (I) PVT LTD;0.00;20.00;3441.00;3421.00
14/10/2019 15:54:46;Meal card;1230353662485;SODEXO FOOD SOLUTIONS (I) PVT LTD;0.00;10.00;3451.00;3441.00
14/10/2019 15:49:00;Meal card;1221273656084;SODEXO FOOD SOLUTIONS (I) PVT LTD;0.00;20.00;3471.00;3451.00
14/10/2019 13:04:13;Meal card;1230003627494;SODEXO FOOD SOLUTIONS (I) PVT LTD;0.00;65.00;3536.00;3471.00
14/10/2019 09:51:26;Meal card;1220943596782;SODEXO FOOD SOLUTIONS (I) PVT LTD;0.00;35.00;3571.00;3536.00
11/10/2019 17:09:27;Meal card;1220943060001;SODEXO FOOD SOLUTIONS (I) PVT LTD;0.00;30.00;3601.00;3571.00
11/10/2019 13:06:43;Meal card;1220943021423;SODEXO FOOD SOLUTIONS (I) PVT LTD;0.00;35.00;3636.00;3601.00
11/10/2019 12:54:09;Meal card;1223233020026;SODEXO FOOD SOLUTIONS (I) PVT LTD;0.00;55.00;3691.00;3636.00
11/10/2019 10:45:07;Meal card;1223233006866;SODEXO FOOD SOLUTIONS (I) PVT LTD;0.00;10.00;3701.00;3691.00
11/10/2019 10:42:23;Meal card;1228393005051;SODEXO FOOD SOLUTIONS (I) PVT LTD;0.00;20.00;3721.00;3701.00
10/10/2019 17:05:33;Meal card;1223232837563;SODEXO FOOD SOLUTIONS (I) PVT LTD;0.00;10.00;3731.00;3721.00
10/10/2019 16:53:01;Meal card;1223232834966;SODEXO FOOD SOLUTIONS (I) PVT LTD;0.00;50.00;3781.00;3731.00
10/10/2019 12:59:20;Meal card;1223232793379;SODEXO FOOD SOLUTIONS (I) PVT LTD;0.00;35.00;3816.00;3781.00
10/10/2019 10:44:10;Meal card;1221152775391;SODEXO FOOD SOLUTIONS (I) PVT LTD;0.00;10.00;3826.00;3816.00
10/10/2019 10:36:17;Meal card;1221082773595;SODEXO FOOD SOLUTIONS (I) PVT LTD;0.00;20.00;3846.00;3826.00
09/10/2019 16:56:19;Meal card;1221152606426;SODEXO FOOD SOLUTIONS (I) PVT LTD;0.00;10.00;3856.00;3846.00
09/10/2019 16:49:58;Meal card;1220942604561;SODEXO FOOD SOLUTIONS (I) PVT LTD;0.00;20.00;3876.00;3856.00
09/10/2019 13:38:53;Meal card;1221082571315;SODEXO FOOD SOLUTIONS (I) PVT LTD;0.00;35.00;3911.00;3876.00
09/10/2019 10:41:47;Meal card;1221092533459;SODEXO FOOD SOLUTIONS (I) PVT LTD;0.00;10.00;3921.00;3911.00
09/10/2019 10:16:26;Meal card;1221082529099;SODEXO FOOD SOLUTIONS (I) PVT LTD;0.00;38.00;3959.00;3921.00
07/10/2019 15:44:50;Meal card;1221152130489;SODEXO FOOD SOLUTIONS (I) PVT LTD;0.00;10.00;3969.00;3959.00
07/10/2019 15:43:48;Meal card;1220942128570;SODEXO FOOD SOLUTIONS (I) PVT LTD;0.00;40.00;4009.00;3969.00
07/10/2019 13:25:17;Meal card;1221272100169;SODEXO FOOD SOLUTIONS (I) PVT LTD;0.00;65.00;4074.00;4009.00
07/10/2019 11:17:11;Meal card;1221082080666;CAPGEMINI TECHNOLOGY SERVICES INDIA LTD;2000.00;0.00;2074.00;4074.00
07/10/2019 10:34:59;Meal card;1221082073333;SODEXO FOOD SOLUTIONS (I) PVT LTD;0.00;35.00;2109.00;2074.00
07/10/2019 10:24:40;Meal card;1223232072979;SODEXO FOOD SOLUTIONS (I) PVT LTD;0.00;30.00;2139.00;2109.00
03/10/2019 16:15:22;Meal card;1221081218749;SODEXO FOOD SOLUTIONS (I) PVT LTD;0.00;20.00;2159.00;2139.00
03/10/2019 16:12:09;Meal card;1221091216651;SODEXO FOOD SOLUTIONS (I) PVT LTD;0.00;38.00;2197.00;2159.00
03/10/2019 13:07:06;Meal card;1221091174194;SODEXO FOOD SOLUTIONS (I) PVT LTD;0.00;35.00;2232.00;2197.00
03/10/2019 10:21:28;Meal card;1221151142049;SODEXO FOOD SOLUTIONS (I) PVT LTD;0.00;10.00;2242.00;2232.00
03/10/2019 10:09:49;Meal card;1221151140030;SODEXO FOOD SOLUTIONS (I) PVT LTD;0.00;20.00;2262.00;2242.00
01/10/2019 14:35:21;Meal card;122109749267;SODEXO FOOD SOLUTIONS (I) PVT LTD;0.00;35.00;2297.00;2262.00
01/10/2019 14:09:19;Meal card;122115744277;SODEXO FOOD SOLUTIONS (I) PVT LTD;0.00;84.00;2381.00;2297.00
01/10/2019 10:42:49;Meal card;122109704233;SODEXO FOOD SOLUTIONS (I) PVT LTD;0.00;10.00;2391.00;2381.00
01/10/2019 10:31:15;Meal card;122323703335;SODEXO FOOD SOLUTIONS (I) PVT LTD;0.00;30.00;2421.00;2391.00
30/09/2019 16:00:13;Meal card;122127554470;SODEXO FOOD SOLUTIONS (I) PVT LTD;0.00;10.00;2431.00;2421.00
30/09/2019 13:59:08;Meal card;122094539759;SODEXO FOOD SOLUTIONS (I) PVT LTD;0.00;65.00;2496.00;2431.00
30/09/2019 10:07:37;Meal card;122109502847;SODEXO FOOD SOLUTIONS (I) PVT LTD;0.00;35.00;2531.00;2496.00
30/09/2019 09:59:27;Meal card;122122501786;SODEXO FOOD SOLUTIONS (I) PVT LTD;0.00;20.00;2551.00;2531.00
27/09/2019 15:12:06;Meal card;122094233270;SODEXO FOOD SOLUTIONS (I) PVT LTD;0.00;10.00;2561.00;2551.00
27/09/2019 15:08:30;Meal card;122115233867;SODEXO FOOD SOLUTIONS (I) PVT LTD;0.00;20.00;2581.00;2561.00
26/09/2019 17:12:07;Meal card;122122114538;SODEXO FOOD SOLUTIONS (I) PVT LTD;0.00;20.00;2601.00;2581.00
26/09/2019 14:20:43;Meal card;122120095193;SODEXO FOOD SOLUTIONS (I) PVT LTD;0.00;35.00;2636.00;2601.00
26/09/2019 14:06:39;Meal card;122115092369;SODEXO FOOD SOLUTIONS (I) PVT LTD;0.00;65.00;2701.00;2636.00
26/09/2019 10:45:14;Meal card;122108060458;SODEXO FOOD SOLUTIONS (I) PVT LTD;0.00;10.00;2711.00;2701.00
26/09/2019 10:35:51;Meal card;122108059591;SODEXO FOOD SOLUTIONS (I) PVT LTD;0.00;20.00;2731.00;2711.00
25/09/2019 14:55:50;Meal card;1214741265759;SODEXO FOOD SOLUTIONS (I) PVT LTD;0.00;35.00;2766.00;2731.00
25/09/2019 14:33:44;Meal card;1214771261098;SODEXO FOOD SOLUTIONS (I) PVT LTD;0.00;38.00;2804.00;2766.00
25/09/2019 10:40:43;Meal card;1215031111873;SODEXO FOOD SOLUTIONS (I) PVT LTD;0.00;10.00;2814.00;2804.00
25/09/2019 10:31:28;Meal card;1214761223465;SODEXO FOOD SOLUTIONS (I) PVT LTD;0.00;20.00;2834.00;2814.00
24/09/2019 17:26:48;Meal card;1214751149827;SODEXO FOOD SOLUTIONS (I) PVT LTD;0.00;10.00;2844.00;2834.00
24/09/2019 17:22:18;Meal card;1214741148364;SODEXO FOOD SOLUTIONS (I) PVT LTD;0.00;20.00;2864.00;2844.00
24/09/2019 10:24:24;Meal card;121502986376;SODEXO FOOD SOLUTIONS (I) PVT LTD;0.00;38.00;2902.00;2864.00
23/09/2019 16:59:50;Meal card;121503873270;SODEXO FOOD SOLUTIONS (I) PVT LTD;0.00;10.00;2912.00;2902.00
23/09/2019 14:17:12;Meal card;121472969014;SODEXO FOOD SOLUTIONS (I) PVT LTD;0.00;116.00;3028.00;2912.00
23/09/2019 11:28:34;Meal card;121502832748;SODEXO FOOD SOLUTIONS (I) PVT LTD;0.00;10.00;3038.00;3028.00
23/09/2019 11:24:31;Meal card;121477936025;SODEXO FOOD SOLUTIONS (I) PVT LTD;0.00;20.00;3058.00;3038.00
23/09/2019 11:18:54;Meal card;121503825678;SODEXO FOOD SOLUTIONS (I) PVT LTD;0.00;35.00;3093.00;3058.00
16/09/2019 16:00:33;Meal card;1213782965314;SODEXO FOOD SOLUTIONS (I) PVT LTD;0.00;15.00;3108.00;3093.00
16/09/2019 14:11:32;Meal card;1214112953641;SODEXO FOOD SOLUTIONS (I) PVT LTD;0.00;65.00;3173.00;3108.00
16/09/2019 10:41:57;Meal card;1207932922916;SODEXO FOOD SOLUTIONS (I) PVT LTD;0.00;10.00;3183.00;3173.00
16/09/2019 10:32:24;Meal card;1207912918639;SODEXO FOOD SOLUTIONS (I) PVT LTD;0.00;20.00;3203.00;3183.00
10/09/2019 16:26:01;Meal card;1207911490162;SODEXO FOOD SOLUTIONS (I) PVT LTD;0.00;20.00;3223.00;3203.00
10/09/2019 14:20:09;Meal card;1207941465023;SODEXO FOOD SOLUTIONS (I) PVT LTD;0.00;35.00;3258.00;3223.00
10/09/2019 14:09:06;Meal card;1207961461273;SODEXO FOOD SOLUTIONS (I) PVT LTD;0.00;55.00;3313.00;3258.00
10/09/2019 10:27:57;Meal card;1207931403236;SODEXO FOOD SOLUTIONS (I) PVT LTD;0.00;10.00;3323.00;3313.00
10/09/2019 10:17:46;Meal card;1207941400342;SODEXO FOOD SOLUTIONS (I) PVT LTD;0.00;20.00;3343.00;3323.00
03/09/2019 16:22:53;Meal card;120331611731;SODEXO FOOD SOLUTIONS (I) PVT LTD;0.00;10.00;3353.00;3343.00
03/09/2019 14:36:28;Meal card;120331601464;SODEXO FOOD SOLUTIONS (I) PVT LTD;0.00;35.00;3388.00;3353.00
03/09/2019 14:24:52;Meal card;120332596259;SODEXO FOOD SOLUTIONS (I) PVT LTD;0.00;75.00;3463.00;3388.00
03/09/2019 10:14:29;Meal card;120330556949;SODEXO FOOD SOLUTIONS (I) PVT LTD;0.00;10.00;3473.00;3463.00
03/09/2019 10:02:03;Meal card;120329556858;SODEXO FOOD SOLUTIONS (I) PVT LTD;0.00;30.00;3503.00;3473.00
30/08/2019 18:52:05;Meal card;120330240404;CAPGEMINI TECHNOLOGY SERVICES INDIA LTD;2000.00;0.00;1503.00;3503.00
28/08/2019 15:38:17;Meal card;1195401455361;SODEXO FOOD SOLUTIONS (I) PVT LTD;0.00;15.00;1518.00;1503.00
28/08/2019 14:10:51;Meal card;1195421444606;SODEXO FOOD SOLUTIONS (I) PVT LTD;0.00;35.00;1553.00;1518.00
28/08/2019 13:55:49;Meal card;1195451440717;SODEXO FOOD SOLUTIONS (I) PVT LTD;0.00;65.00;1618.00;1553.00
28/08/2019 10:13:54;Meal card;1195401414942;SODEXO FOOD SOLUTIONS (I) PVT LTD;0.00;10.00;1628.00;1618.00
28/08/2019 10:01:02;Meal card;1195451410068;SODEXO FOOD SOLUTIONS (I) PVT LTD;0.00;30.00;1658.00;1628.00
27/08/2019 16:50:38;Meal card;1195421335575;SODEXO FOOD SOLUTIONS (I) PVT LTD;0.00;8.00;1666.00;1658.00
27/08/2019 16:48:36;Meal card;1195431336697;SODEXO FOOD SOLUTIONS (I) PVT LTD;0.00;20.00;1686.00;1666.00
27/08/2019 14:18:41;Meal card;1199871323086;SODEXO FOOD SOLUTIONS (I) PVT LTD;0.00;35.00;1721.00;1686.00
27/08/2019 14:04:52;Meal card;1195401320794;SODEXO FOOD SOLUTIONS (I) PVT LTD;0.00;65.00;1786.00;1721.00
27/08/2019 10:26:49;Meal card;1195421287017;SODEXO FOOD SOLUTIONS (I) PVT LTD;0.00;10.00;1796.00;1786.00
27/08/2019 10:14:38;Meal card;1198211283906;SODEXO FOOD SOLUTIONS (I) PVT LTD;0.00;20.00;1816.00;1796.00
22/08/2019 14:13:05;Meal card;119545801253;SODEXO FOOD SOLUTIONS (I) PVT LTD;0.00;35.00;1851.00;1816.00
22/08/2019 14:00:13;Meal card;119541799463;SODEXO FOOD SOLUTIONS (I) PVT LTD;0.00;65.00;1916.00;1851.00
22/08/2019 10:30:12;Meal card;119540769180;SODEXO FOOD SOLUTIONS (I) PVT LTD;0.00;10.00;1926.00;1916.00
22/08/2019 10:21:55;Meal card;119546763143;SODEXO FOOD SOLUTIONS (I) PVT LTD;0.00;30.00;1956.00;1926.00
21/08/2019 16:35:44;Meal card;119546675987;SODEXO FOOD SOLUTIONS (I) PVT LTD;0.00;10.00;1966.00;1956.00
21/08/2019 14:25:52;Meal card;119540667828;SODEXO FOOD SOLUTIONS (I) PVT LTD;0.00;35.00;2001.00;1966.00
21/08/2019 14:07:30;Meal card;119542665309;SODEXO FOOD SOLUTIONS (I) PVT LTD;0.00;75.00;2076.00;2001.00
21/08/2019 10:17:12;Meal card;119545631623;SODEXO FOOD SOLUTIONS (I) PVT LTD;0.00;35.00;2111.00;2076.00
21/08/2019 10:07:04;Meal card;119545630730;SODEXO FOOD SOLUTIONS (I) PVT LTD;0.00;20.00;2131.00;2111.00
20/08/2019 16:20:52;Meal card;119541543706;SODEXO FOOD SOLUTIONS (I) PVT LTD;0.00;30.00;2161.00;2131.00
20/08/2019 14:22:46;Meal card;119544531414;SODEXO FOOD SOLUTIONS (I) PVT LTD;0.00;35.00;2196.00;2161.00
20/08/2019 14:08:32;Meal card;119544529020;SODEXO FOOD SOLUTIONS (I) PVT LTD;0.00;65.00;2261.00;2196.00
20/08/2019 10:25:34;Meal card;119540494926;SODEXO FOOD SOLUTIONS (I) PVT LTD;0.00;38.00;2299.00;2261.00
19/08/2019 16:51:03;Meal card;119543420532;SODEXO FOOD SOLUTIONS (I) PVT LTD;0.00;10.00;2309.00;2299.00
19/08/2019 14:14:48;Meal card;119540403089;SODEXO FOOD SOLUTIONS (I) PVT LTD;0.00;35.00;2344.00;2309.00
19/08/2019 14:02:36;Meal card;119545402419;SODEXO FOOD SOLUTIONS (I) PVT LTD;0.00;65.00;2409.00;2344.00
19/08/2019 10:32:43;Meal card;119546369251;SODEXO FOOD SOLUTIONS (I) PVT LTD;0.00;25.00;2434.00;2409.00
14/08/2019 16:51:24;Meal card;1187831459095;SODEXO FOOD SOLUTIONS (I) PVT LTD;0.00;10.00;2444.00;2434.00
14/08/2019 16:49:23;Meal card;1189131461725;SODEXO FOOD SOLUTIONS (I) PVT LTD;0.00;40.00;2484.00;2444.00
14/08/2019 10:24:36;Meal card;1187841405287;SODEXO FOOD SOLUTIONS (I) PVT LTD;0.00;10.00;2494.00;2484.00
14/08/2019 10:16:08;Meal card;1189131409346;SODEXO FOOD SOLUTIONS (I) PVT LTD;0.00;20.00;2514.00;2494.00
13/08/2019 16:43:12;Meal card;1189371301119;SODEXO FOOD SOLUTIONS (I) PVT LTD;0.00;20.00;2534.00;2514.00
13/08/2019 14:14:30;Meal card;1189131286803;SODEXO FOOD SOLUTIONS (I) PVT LTD;0.00;35.00;2569.00;2534.00
13/08/2019 14:02:49;Meal card;1187831280860;SODEXO FOOD SOLUTIONS (I) PVT LTD;0.00;65.00;2634.00;2569.00
13/08/2019 10:21:36;Meal card;1189371249353;SODEXO FOOD SOLUTIONS (I) PVT LTD;0.00;10.00;2644.00;2634.00
13/08/2019 10:19:38;Meal card;1189131251500;SODEXO FOOD SOLUTIONS (I) PVT LTD;0.00;20.00;2664.00;2644.00
13/08/2019 10:13:41;Meal card;1189151245966;SODEXO FOOD SOLUTIONS (I) PVT LTD;0.00;35.00;2699.00;2664.00
09/08/2019 14:42:52;Meal card;118915823698;SODEXO FOOD SOLUTIONS (I) PVT LTD;0.00;35.00;2734.00;2699.00
09/08/2019 14:29:19;Meal card;118915821955;SODEXO FOOD SOLUTIONS (I) PVT LTD;0.00;65.00;2799.00;2734.00
09/08/2019 10:06:54;Meal card;118937787070;SODEXO FOOD SOLUTIONS (I) PVT LTD;0.00;10.00;2809.00;2799.00
09/08/2019 09:54:02;Meal card;118960785320;SODEXO FOOD SOLUTIONS (I) PVT LTD;0.00;38.00;2847.00;2809.00
06/08/2019 17:37:21;Meal card;118780321450;SODEXO FOOD SOLUTIONS (I) PVT LTD;0.00;10.00;2857.00;2847.00
06/08/2019 17:28:20;Meal card;118782319840;SODEXO FOOD SOLUTIONS (I) PVT LTD;0.00;35.00;2892.00;2857.00
06/08/2019 17:26:04;Meal card;118786315744;SODEXO FOOD SOLUTIONS (I) PVT LTD;0.00;20.00;2912.00;2892.00
06/08/2019 14:54:31;Meal card;118784293844;CAPGEMINI TECHNOLOGY SERVICES INDIA LTD;2000.00;0.00;912.00;2912.00
06/08/2019 14:33:39;Meal card;118783289967;SODEXO FOOD SOLUTIONS (I) PVT LTD;0.00;65.00;977.00;912.00
06/08/2019 10:42:53;Meal card;118783249760;SODEXO FOOD SOLUTIONS (I) PVT LTD;0.00;10.00;987.00;977.00
06/08/2019 10:18:00;Meal card;118784247858;SODEXO FOOD SOLUTIONS (I) PVT LTD;0.00;28.00;1015.00;987.00
01/08/2019 18:24:45;Meal card;1177071920437;SODEXO FOOD SOLUTIONS (I) PVT LTD;0.00;10.00;1025.00;1015.00
01/08/2019 18:19:59;Meal card;1184451920157;SODEXO FOOD SOLUTIONS (I) PVT LTD;0.00;20.00;1045.00;1025.00
01/08/2019 14:17:22;Meal card;1184761880234;SODEXO FOOD SOLUTIONS (I) PVT LTD;0.00;65.00;1110.00;1045.00
01/08/2019 11:20:04;Meal card;1176981850265;SODEXO FOOD SOLUTIONS (I) PVT LTD;0.00;10.00;1120.00;1110.00
01/08/2019 11:17:06;Meal card;1176981849883;SODEXO FOOD SOLUTIONS (I) PVT LTD;0.00;38.00;1158.00;1120.00
31/07/2019 16:31:42;Meal card;118285787059;SODEXO FOOD SOLUTIONS (I) PVT LTD;0.00;10.00;1168.00;1158.00
31/07/2019 14:02:29;Meal card;1184611674768;SODEXO FOOD SOLUTIONS (I) PVT LTD;0.00;65.00;1233.00;1168.00
31/07/2019 10:41:11;Meal card;118337682310;SODEXO FOOD SOLUTIONS (I) PVT LTD;0.00;10.00;1243.00;1233.00
31/07/2019 10:30:50;Meal card;1176981642169;SODEXO FOOD SOLUTIONS (I) PVT LTD;0.00;38.00;1281.00;1243.00
26/07/2019 15:59:41;Meal card;1177001154488;SODEXO FOOD SOLUTIONS (I) PVT LTD;0.00;25.00;1306.00;1281.00
26/07/2019 14:10:47;Meal card;1176941139869;SODEXO FOOD SOLUTIONS (I) PVT LTD;0.00;65.00;1371.00;1306.00
25/07/2019 17:49:55;Meal card;1177131023024;SODEXO FOOD SOLUTIONS (I) PVT LTD;0.00;10.00;1381.00;1371.00
25/07/2019 17:48:19;Meal card;118337070507;SODEXO FOOD SOLUTIONS (I) PVT LTD;0.00;20.00;1401.00;1381.00
25/07/2019 13:55:36;Meal card;117694997355;SODEXO FOOD SOLUTIONS (I) PVT LTD;0.00;65.00;1466.00;1401.00
25/07/2019 10:10:22;Meal card;117713962891;SODEXO FOOD SOLUTIONS (I) PVT LTD;0.00;25.00;1491.00;1466.00
25/07/2019 10:03:07;Meal card;118337010516;SODEXO FOOD SOLUTIONS (I) PVT LTD;0.00;25.00;1516.00;1491.00
24/07/2019 17:54:53;Meal card;117698875265;SODEXO FOOD SOLUTIONS (I) PVT LTD;0.00;10.00;1526.00;1516.00
24/07/2019 17:42:08;Meal card;117700874858;SODEXO FOOD SOLUTIONS (I) PVT LTD;0.00;20.00;1546.00;1526.00
24/07/2019 13:54:43;Meal card;117694842968;SODEXO FOOD SOLUTIONS (I) PVT LTD;0.00;80.00;1626.00;1546.00
24/07/2019 11:01:32;Meal card;117697818385;SODEXO FOOD SOLUTIONS (I) PVT LTD;0.00;10.00;1636.00;1626.00
24/07/2019 10:36:59;Meal card;117700819031;SODEXO FOOD SOLUTIONS (I) PVT LTD;0.00;10.00;1646.00;1636.00
24/07/2019 10:34:44;Meal card;117698817789;SODEXO FOOD SOLUTIONS (I) PVT LTD;0.00;38.00;1684.00;1646.00
23/07/2019 16:04:03;Meal card;117697716028;SODEXO FOOD SOLUTIONS (I) PVT LTD;0.00;10.00;1694.00;1684.00
23/07/2019 16:02:58;Meal card;117707718884;SODEXO FOOD SOLUTIONS (I) PVT LTD;0.00;20.00;1714.00;1694.00
23/07/2019 12:55:29;Meal card;117692689036;SODEXO FOOD SOLUTIONS (I) PVT LTD;0.00;48.00;1762.00;1714.00
23/07/2019 12:51:19;Meal card;117713683398;SODEXO FOOD SOLUTIONS (I) PVT LTD;0.00;35.00;1797.00;1762.00
23/07/2019 10:24:06;Meal card;117700677034;SODEXO FOOD SOLUTIONS (I) PVT LTD;0.00;25.00;1822.00;1797.00
23/07/2019 10:07:13;Meal card;117694671631;SODEXO FOOD SOLUTIONS (I) PVT LTD;0.00;30.00;1852.00;1822.00
22/07/2019 16:52:42;Meal card;117697588224;SODEXO FOOD SOLUTIONS (I) PVT LTD;0.00;10.00;1862.00;1852.00
22/07/2019 16:50:46;Meal card;117692588870;SODEXO FOOD SOLUTIONS (I) PVT LTD;0.00;20.00;1882.00;1862.00
22/07/2019 13:00:07;Meal card;117694553103;SODEXO FOOD SOLUTIONS (I) PVT LTD;0.00;60.00;1942.00;1882.00
22/07/2019 10:52:18;Meal card;117697541322;SODEXO FOOD SOLUTIONS (I) PVT LTD;0.00;10.00;1952.00;1942.00
22/07/2019 10:37:39;Meal card;117692540787;SODEXO FOOD SOLUTIONS (I) PVT LTD;0.00;28.00;1980.00;1952.00
19/07/2019 16:59:30;Meal card;117700282881;SODEXO FOOD SOLUTIONS (I) PVT LTD;0.00;10.00;1990.00;1980.00
19/07/2019 13:54:22;Meal card;117698261125;SODEXO FOOD SOLUTIONS (I) PVT LTD;0.00;65.00;2055.00;1990.00
19/07/2019 10:22:54;Meal card;117707234041;SODEXO FOOD SOLUTIONS (I) PVT LTD;0.00;10.00;2065.00;2055.00
19/07/2019 10:20:36;Meal card;117694231882;SODEXO FOOD SOLUTIONS (I) PVT LTD;0.00;20.00;2085.00;2065.00
19/07/2019 10:13:30;Meal card;117692231855;SODEXO FOOD SOLUTIONS (I) PVT LTD;0.00;35.00;2120.00;2085.00
18/07/2019 17:23:42;Meal card;117707094158;SODEXO FOOD SOLUTIONS (I) PVT LTD;0.00;10.00;2130.00;2120.00
18/07/2019 10:12:41;Meal card;117692033414;SODEXO FOOD SOLUTIONS (I) PVT LTD;0.00;10.00;2140.00;2130.00
18/07/2019 09:57:52;Meal card;117700031479;SODEXO FOOD SOLUTIONS (I) PVT LTD;0.00;25.00;2165.00;2140.00
18/07/2019 09:50:39;Meal card;117694030400;SODEXO FOOD SOLUTIONS (I) PVT LTD;0.00;35.00;2200.00;2165.00
17/07/2019 17:51:39;Meal card;1163021935301;SODEXO FOOD SOLUTIONS (I) PVT LTD;0.00;25.00;2225.00;2200.00
17/07/2019 13:12:37;Meal card;1169851889590;SODEXO FOOD SOLUTIONS (I) PVT LTD;0.00;65.00;2290.00;2225.00
17/07/2019 09:54:13;Meal card;1163041867059;SODEXO FOOD SOLUTIONS (I) PVT LTD;0.00;10.00;2300.00;2290.00
16/07/2019 17:42:00;Meal card;117527706004;SODEXO FOOD SOLUTIONS (I) PVT LTD;0.00;10.00;2310.00;2300.00
16/07/2019 13:14:22;Meal card;1171031764328;SODEXO FOOD SOLUTIONS (I) PVT LTD;0.00;55.00;2365.00;2310.00
16/07/2019 11:28:04;Meal card;1171031749939;SODEXO FOOD SOLUTIONS (I) PVT LTD;0.00;20.00;2385.00;2365.00
16/07/2019 09:56:55;Meal card;117571252745;SODEXO FOOD SOLUTIONS (I) PVT LTD;0.00;10.00;2395.00;2385.00
16/07/2019 09:44:08;Meal card;1171031740948;SODEXO FOOD SOLUTIONS (I) PVT LTD;0.00;30.00;2425.00;2395.00
15/07/2019 17:18:26;Meal card;1163191653425;SODEXO FOOD SOLUTIONS (I) PVT LTD;0.00;10.00;2435.00;2425.00
15/07/2019 17:08:07;Meal card;1163191651310;SODEXO FOOD SOLUTIONS (I) PVT LTD;0.00;30.00;2465.00;2435.00
15/07/2019 10:29:25;Meal card;1171031597240;SODEXO FOOD SOLUTIONS (I) PVT LTD;0.00;10.00;2475.00;2465.00
15/07/2019 10:20:52;Meal card;117527498186;SODEXO FOOD SOLUTIONS (I) PVT LTD;0.00;10.00;2485.00;2475.00
15/07/2019 10:18:53;Meal card;1163191597285;SODEXO FOOD SOLUTIONS (I) PVT LTD;0.00;38.00;2523.00;2485.00
12/07/2019 15:35:28;Meal card;1163021317636;SODEXO FOOD SOLUTIONS (I) PVT LTD;0.00;25.00;2548.00;2523.00
12/07/2019 11:32:59;Meal card;1169851273593;SODEXO FOOD SOLUTIONS (I) PVT LTD;0.00;10.00;2558.00;2548.00
12/07/2019 11:15:07;Meal card;1163191277077;SODEXO FOOD SOLUTIONS (I) PVT LTD;0.00;38.00;2596.00;2558.00
11/07/2019 16:02:57;Meal card;1163191156486;SODEXO FOOD SOLUTIONS (I) PVT LTD;0.00;15.00;2611.00;2596.00
11/07/2019 13:36:24;Meal card;1163041133218;SODEXO FOOD SOLUTIONS (I) PVT LTD;0.00;65.00;2676.00;2611.00
11/07/2019 11:07:30;Meal card;1163041109805;SODEXO FOOD SOLUTIONS (I) PVT LTD;0.00;10.00;2686.00;2676.00
11/07/2019 10:58:03;Meal card;117525016506;SODEXO FOOD SOLUTIONS (I) PVT LTD;0.00;38.00;2724.00;2686.00
10/07/2019 14:07:35;Meal card;116302974104;SODEXO FOOD SOLUTIONS (I) PVT LTD;0.00;65.00;2789.00;2724.00
10/07/2019 11:46:39;Meal card;117103946724;SODEXO FOOD SOLUTIONS (I) PVT LTD;0.00;30.00;2819.00;2789.00
10/07/2019 10:03:39;Meal card;116304933074;SODEXO FOOD SOLUTIONS (I) PVT LTD;0.00;70.00;2889.00;2819.00
09/07/2019 16:37:34;Meal card;116320814264;SODEXO FOOD SOLUTIONS (I) PVT LTD;0.00;25.00;2914.00;2889.00
09/07/2019 14:10:08;Meal card;116307802464;SODEXO FOOD SOLUTIONS (I) PVT LTD;0.00;55.00;2969.00;2914.00
09/07/2019 10:07:39;Meal card;116307764558;SODEXO FOOD SOLUTIONS (I) PVT LTD;0.00;70.00;3039.00;2969.00
05/07/2019 19:38:46;Meal card;116304347877;CAPGEMINI TECHNOLOGY SERVICES INDIA LTD;2000.00;0.00;1039.00;3039.00
05/07/2019 10:26:57;Meal card;116303265346;SODEXO FOOD SOLUTIONS (I) PVT LTD;0.00;10.00;1049.00;1039.00
05/07/2019 10:06:04;Meal card;116319262503;SODEXO FOOD SOLUTIONS (I) PVT LTD;0.00;38.00;1087.00;1049.00
05/07/2019 09:56:59;Meal card;116320258611;SODEXO FOOD SOLUTIONS (I) PVT LTD;0.00;30.00;1117.00;1087.00
04/07/2019 16:15:07;Meal card;116307138995;SODEXO FOOD SOLUTIONS (I) PVT LTD;0.00;25.00;1142.00;1117.00
04/07/2019 12:48:17;Meal card;116320100861;SODEXO FOOD SOLUTIONS (I) PVT LTD;0.00;35.00;1177.00;1142.00
04/07/2019 12:46:31;Meal card;116320100498;SODEXO FOOD SOLUTIONS (I) PVT LTD;0.00;25.00;1202.00;1177.00
04/07/2019 10:19:35;Meal card;116320084874;SODEXO FOOD SOLUTIONS (I) PVT LTD;0.00;10.00;1212.00;1202.00
04/07/2019 10:08:15;Meal card;116304084971;SODEXO FOOD SOLUTIONS (I) PVT LTD;0.00;25.00;1237.00;1212.00
03/07/2019 10:17:59;Meal card;1157101574022;SODEXO FOOD SOLUTIONS (I) PVT LTD;0.00;10.00;1247.00;1237.00
03/07/2019 10:08:54;Meal card;1157151570759;SODEXO FOOD SOLUTIONS (I) PVT LTD;0.00;30.00;1277.00;1247.00
02/07/2019 15:52:03;Meal card;1157131465473;SODEXO FOOD SOLUTIONS (I) PVT LTD;0.00;15.00;1292.00;1277.00
02/07/2019 12:56:12;Meal card;1157121438683;SODEXO FOOD SOLUTIONS (I) PVT LTD;0.00;65.00;1357.00;1292.00
02/07/2019 10:13:35;Meal card;1157121420459;SODEXO FOOD SOLUTIONS (I) PVT LTD;0.00;10.00;1367.00;1357.00
02/07/2019 10:02:53;Meal card;1157101418827;SODEXO FOOD SOLUTIONS (I) PVT LTD;0.00;35.00;1402.00;1367.00
01/07/2019 15:35:57;Meal card;1157121312866;SODEXO FOOD SOLUTIONS (I) PVT LTD;0.00;10.00;1412.00;1402.00
01/07/2019 15:09:30;Meal card;1157851303674;SODEXO FOOD SOLUTIONS (I) PVT LTD;0.00;76.00;1488.00;1412.00
01/07/2019 11:11:23;Meal card;1157121272337;SODEXO FOOD SOLUTIONS (I) PVT LTD;0.00;10.00;1498.00;1488.00
01/07/2019 10:52:25;Meal card;1157151266192;SODEXO FOOD SOLUTIONS (I) PVT LTD;0.00;28.00;1526.00;1498.00
13/03/2020 12:44:41;Meal card;147324196702;SODEXO FOOD SOLUTIONS (I) PVT LTD;0.00;98.00;1994.00;1896.00
13/03/2020 10:01:03;Meal card;147321183020;SODEXO FOOD SOLUTIONS (I) PVT LTD;0.00;25.00;2019.00;1994.00
12/03/2020 13:10:36;Meal card;147329056422;SODEXO FOOD SOLUTIONS (I) PVT LTD;0.00;65.00;2084.00;2019.00
12/03/2020 10:08:57;Meal card;147325041014;SODEXO FOOD SOLUTIONS (I) PVT LTD;0.00;25.00;2109.00;2084.00
11/03/2020 13:22:44;Meal card;1464152188053;SODEXO FOOD SOLUTIONS (I) PVT LTD;0.00;35.00;2144.00;2109.00
11/03/2020 12:55:31;Meal card;1464232188377;SODEXO FOOD SOLUTIONS (I) PVT LTD;0.00;98.00;2242.00;2144.00
09/03/2020 19:22:28;Meal card;1464232007850;CAPGEMINI TECHNOLOGY SERVICES INDIA LTD;2000.00;0.00;242.00;2242.00
06/03/2020 15:48:58;Meal card;1466991418548;SODEXO FOOD SOLUTIONS (I) PVT LTD;0.00;10.00;252.00;242.00
06/03/2020 15:44:59;Meal card;1464031367293;SODEXO FOOD SOLUTIONS (I) PVT LTD;0.00;38.00;290.00;252.00
06/03/2020 12:44:35;Meal card;1464241400951;SODEXO FOOD SOLUTIONS (I) PVT LTD;0.00;70.00;360.00;290.00
06/03/2020 10:08:18;Meal card;1464031329434;SODEXO FOOD SOLUTIONS (I) PVT LTD;0.00;20.00;380.00;360.00
05/03/2020 13:05:59;Meal card;1465011300802;SODEXO FOOD SOLUTIONS (I) PVT LTD;0.00;65.00;445.00;380.00
05/03/2020 10:11:03;Meal card;1465011283929;SODEXO FOOD SOLUTIONS (I) PVT LTD;0.00;25.00;470.00;445.00
04/03/2020 17:14:44;Meal card;1466991211615;SODEXO FOOD SOLUTIONS (I) PVT LTD;0.00;35.00;505.00;470.00
04/03/2020 13:01:56;Meal card;1464031123120;SODEXO FOOD SOLUTIONS (I) PVT LTD;0.00;98.00;603.00;505.00
03/03/2020 13:26:33;Meal card;1466991054268;SODEXO FOOD SOLUTIONS (I) PVT LTD;0.00;65.00;668.00;603.00
02/03/2020 17:23:55;Meal card;146405967270;SODEXO FOOD SOLUTIONS (I) PVT LTD;0.00;10.00;678.00;668.00
02/03/2020 17:15:55;Meal card;146403912086;SODEXO FOOD SOLUTIONS (I) PVT LTD;0.00;35.00;713.00;678.00
02/03/2020 13:30:01;Meal card;146433936502;SODEXO FOOD SOLUTIONS (I) PVT LTD;0.00;65.00;778.00;713.00
02/03/2020 10:13:51;Meal card;146448916724;SODEXO FOOD SOLUTIONS (I) PVT LTD;0.00;20.00;798.00;778.00
28/02/2020 13:12:35;Meal card;146433666833;SODEXO FOOD SOLUTIONS (I) PVT LTD;0.00;35.00;833.00;798.00
28/02/2020 13:02:17;Meal card;146433664305;SODEXO FOOD SOLUTIONS (I) PVT LTD;0.00;55.00;888.00;833.00
28/02/2020 10:05:47;Meal card;146405646707;SODEXO FOOD SOLUTIONS (I) PVT LTD;0.00;25.00;913.00;888.00
27/02/2020 15:31:31;Meal card;145497546393;SODEXO FOOD SOLUTIONS (I) PVT LTD;0.00;38.00;951.00;913.00
27/02/2020 12:51:01;Meal card;145497524867;SODEXO FOOD SOLUTIONS (I) PVT LTD;0.00;35.00;986.00;951.00
27/02/2020 11:24:17;Meal card;145440519366;SODEXO FOOD SOLUTIONS (I) PVT LTD;0.00;20.00;1006.00;986.00
26/02/2020 12:55:42;Meal card;145571407225;SODEXO FOOD SOLUTIONS (I) PVT LTD;0.00;35.00;1041.00;1006.00
26/02/2020 12:45:04;Meal card;145340425580;SODEXO FOOD SOLUTIONS (I) PVT LTD;0.00;65.00;1106.00;1041.00
25/02/2020 13:42:55;Meal card;145337333866;SODEXO FOOD SOLUTIONS (I) PVT LTD;0.00;35.00;1141.00;1106.00
25/02/2020 13:17:00;Meal card;145347329408;SODEXO FOOD SOLUTIONS (I) PVT LTD;0.00;75.00;1216.00;1141.00
25/02/2020 10:06:15;Meal card;145347313011;SODEXO FOOD SOLUTIONS (I) PVT LTD;0.00;35.00;1251.00;1216.00
24/02/2020 17:06:44;Meal card;145340254740;SODEXO FOOD SOLUTIONS (I) PVT LTD;0.00;38.00;1289.00;1251.00
24/02/2020 13:02:54;Meal card;145497225862;SODEXO FOOD SOLUTIONS (I) PVT LTD;0.00;35.00;1324.00;1289.00
24/02/2020 12:47:16;Meal card;145479212797;SODEXO FOOD SOLUTIONS (I) PVT LTD;0.00;84.00;1408.00;1324.00
20/02/2020 17:18:55;Meal card;1446801407865;SODEXO FOOD SOLUTIONS (I) PVT LTD;0.00;38.00;1446.00;1408.00
20/02/2020 16:06:47;Meal card;1451321399518;SODEXO FOOD SOLUTIONS (I) PVT LTD;0.00;10.00;1456.00;1446.00
20/02/2020 12:45:17;Meal card;1446801372889;SODEXO FOOD SOLUTIONS (I) PVT LTD;0.00;35.00;1491.00;1456.00
20/02/2020 12:44:22;Meal card;1451321372493;SODEXO FOOD SOLUTIONS (I) PVT LTD;0.00;40.00;1531.00;1491.00
19/02/2020 13:08:42;Meal card;1443101265554;SODEXO FOOD SOLUTIONS (I) PVT LTD;0.00;70.00;1601.00;1531.00
19/02/2020 09:57:48;Meal card;1449241250880;SODEXO FOOD SOLUTIONS (I) PVT LTD;0.00;35.00;1636.00;1601.00
18/02/2020 17:00:15;Meal card;1446391171016;SODEXO FOOD SOLUTIONS (I) PVT LTD;0.00;40.00;1676.00;1636.00
18/02/2020 12:59:38;Meal card;1449491142494;SODEXO FOOD SOLUTIONS (I) PVT LTD;0.00;65.00;1741.00;1676.00
18/02/2020 09:49:45;Meal card;1446391124868;SODEXO FOOD SOLUTIONS (I) PVT LTD;0.00;35.00;1776.00;1741.00
17/02/2020 15:37:39;Meal card;1446801047420;SODEXO FOOD SOLUTIONS (I) PVT LTD;0.00;30.00;1806.00;1776.00
17/02/2020 13:06:29;Meal card;1446581029357;SODEXO FOOD SOLUTIONS (I) PVT LTD;0.00;102.00;1908.00;1806.00
17/02/2020 09:45:13;Meal card;1443601012899;SODEXO FOOD SOLUTIONS (I) PVT LTD;0.00;35.00;1943.00;1908.00
14/02/2020 17:36:45;Meal card;144680815043;SODEXO FOOD SOLUTIONS (I) PVT LTD;0.00;70.00;2013.00;1943.00
14/02/2020 12:54:58;Meal card;144658781853;SODEXO FOOD SOLUTIONS (I) PVT LTD;0.00;102.00;2115.00;2013.00
14/02/2020 09:55:24;Meal card;144639767368;SODEXO FOOD SOLUTIONS (I) PVT LTD;0.00;35.00;2150.00;2115.00
13/02/2020 13:01:42;Meal card;144639639590;SODEXO FOOD SOLUTIONS (I) PVT LTD;0.00;76.00;2226.00;2150.00
13/02/2020 09:55:15;Meal card;144658623653;SODEXO FOOD SOLUTIONS (I) PVT LTD;0.00;35.00;2261.00;2226.00
12/02/2020 16:44:33;Meal card;144303525066;SODEXO FOOD SOLUTIONS (I) PVT LTD;0.00;35.00;2296.00;2261.00
12/02/2020 13:08:53;Meal card;144369495657;SODEXO FOOD SOLUTIONS (I) PVT LTD;0.00;75.00;2371.00;2296.00
12/02/2020 10:08:20;Meal card;144413479394;SODEXO FOOD SOLUTIONS (I) PVT LTD;0.00;35.00;2406.00;2371.00
11/02/2020 17:27:19;Meal card;144306386605;SODEXO FOOD SOLUTIONS (I) PVT LTD;0.00;40.00;2446.00;2406.00
11/02/2020 12:42:05;Meal card;144309347365;SODEXO FOOD SOLUTIONS (I) PVT LTD;0.00;76.00;2522.00;2446.00
11/02/2020 10:10:02;Meal card;144303336026;SODEXO FOOD SOLUTIONS (I) PVT LTD;0.00;35.00;2557.00;2522.00
10/02/2020 10:04:42;Meal card;144306204115;SODEXO FOOD SOLUTIONS (I) PVT LTD;0.00;35.00;2592.00;2557.00
07/02/2020 13:52:07;Meal card;144114392667;SODEXO FOOD SOLUTIONS (I) PVT LTD;0.00;40.00;2632.00;2592.00
07/02/2020 10:05:15;Meal card;144114364266;SODEXO FOOD SOLUTIONS (I) PVT LTD;0.00;30.00;2662.00;2632.00
06/02/2020 13:19:58;Meal card;1427371728971;SODEXO FOOD SOLUTIONS (I) PVT LTD;0.00;35.00;2697.00;2662.00
06/02/2020 13:05:58;Meal card;143487725235;SODEXO FOOD SOLUTIONS (I) PVT LTD;0.00;12.00;2709.00;2697.00
06/02/2020 12:55:46;Meal card;143487722645;SODEXO FOOD SOLUTIONS (I) PVT LTD;0.00;82.00;2791.00;2709.00
05/02/2020 20:41:58;Meal card;1427371610297;CAPGEMINI TECHNOLOGY SERVICES INDIA LTD;2000.00;0.00;791.00;2791.00
05/02/2020 17:22:02;Meal card;143855077886;SODEXO FOOD SOLUTIONS (I) PVT LTD;0.00;38.00;829.00;791.00
05/02/2020 13:14:17;Meal card;143403634783;SODEXO FOOD SOLUTIONS (I) PVT LTD;0.00;40.00;869.00;829.00
05/02/2020 13:11:34;Meal card;143403634079;SODEXO FOOD SOLUTIONS (I) PVT LTD;0.00;35.00;904.00;869.00
05/02/2020 09:49:31;Meal card;143403612688;SODEXO FOOD SOLUTIONS (I) PVT LTD;0.00;20.00;924.00;904.00
31/01/2020 17:19:44;Meal card;1430511038321;SODEXO FOOD SOLUTIONS (I) PVT LTD;0.00;70.00;994.00;924.00
31/01/2020 10:04:58;Meal card;143354987287;SODEXO FOOD SOLUTIONS (I) PVT LTD;0.00;10.00;1004.00;994.00
31/01/2020 10:04:07;Meal card;143304082978;SODEXO FOOD SOLUTIONS (I) PVT LTD;0.00;10.00;1014.00;1004.00
31/01/2020 09:59:25;Meal card;143051987848;SODEXO FOOD SOLUTIONS (I) PVT LTD;0.00;45.00;1059.00;1014.00
30/01/2020 13:15:14;Meal card;142983876502;SODEXO FOOD SOLUTIONS (I) PVT LTD;0.00;35.00;1094.00;1059.00
30/01/2020 13:12:16;Meal card;142983875759;SODEXO FOOD SOLUTIONS (I) PVT LTD;0.00;20.00;1114.00;1094.00
30/01/2020 12:54:27;Meal card;142888874005;SODEXO FOOD SOLUTIONS (I) PVT LTD;0.00;75.00;1189.00;1114.00
30/01/2020 09:50:55;Meal card;142465859197;SODEXO FOOD SOLUTIONS (I) PVT LTD;0.00;25.00;1214.00;1189.00
28/01/2020 17:11:34;Meal card;142888646852;SODEXO FOOD SOLUTIONS (I) PVT LTD;0.00;22.00;1236.00;1214.00
28/01/2020 12:58:57;Meal card;142465613076;SODEXO FOOD SOLUTIONS (I) PVT LTD;0.00;35.00;1271.00;1236.00
28/01/2020 12:48:38;Meal card;142734609329;SODEXO FOOD SOLUTIONS (I) PVT LTD;0.00;65.00;1336.00;1271.00
28/01/2020 09:49:43;Meal card;142590595230;SODEXO FOOD SOLUTIONS (I) PVT LTD;0.00;20.00;1356.00;1336.00
27/01/2020 17:27:29;Meal card;142460530644;SODEXO FOOD SOLUTIONS (I) PVT LTD;0.00;70.00;1426.00;1356.00
27/01/2020 17:18:29;Meal card;142590529105;SODEXO FOOD SOLUTIONS (I) PVT LTD;0.00;5.00;1431.00;1426.00
27/01/2020 17:13:15;Meal card;142746528031;SODEXO FOOD SOLUTIONS (I) PVT LTD;0.00;35.00;1466.00;1431.00
27/01/2020 12:47:37;Meal card;142603495261;SODEXO FOOD SOLUTIONS (I) PVT LTD;0.00;75.00;1541.00;1466.00
27/01/2020 09:40:57;Meal card;142444482299;SODEXO FOOD SOLUTIONS (I) PVT LTD;0.00;35.00;1576.00;1541.00
23/01/2020 13:20:57;Meal card;142467082351;SODEXO FOOD SOLUTIONS (I) PVT LTD;0.00;35.00;1611.00;1576.00
23/01/2020 13:17:12;Meal card;142465081634;SODEXO FOOD SOLUTIONS (I) PVT LTD;0.00;35.00;1646.00;1611.00
23/01/2020 10:04:15;Meal card;142465061550;SODEXO FOOD SOLUTIONS (I) PVT LTD;0.00;20.00;1666.00;1646.00
22/01/2020 13:21:26;Meal card;1415011620853;SODEXO FOOD SOLUTIONS (I) PVT LTD;0.00;35.00;1701.00;1666.00
22/01/2020 13:11:40;Meal card;1415011618120;SODEXO FOOD SOLUTIONS (I) PVT LTD;0.00;65.00;1766.00;1701.00
22/01/2020 09:52:45;Meal card;1421851692535;SODEXO FOOD SOLUTIONS (I) PVT LTD;0.00;20.00;1786.00;1766.00
21/01/2020 16:56:52;Meal card;1418071586298;SODEXO FOOD SOLUTIONS (I) PVT LTD;0.00;40.00;1826.00;1786.00
21/01/2020 12:43:56;Meal card;1409461553289;SODEXO FOOD SOLUTIONS (I) PVT LTD;0.00;65.00;1891.00;1826.00
21/01/2020 09:47:58;Meal card;1409461539992;SODEXO FOOD SOLUTIONS (I) PVT LTD;0.00;20.00;1911.00;1891.00
20/01/2020 16:24:02;Meal card;1416751453543;SODEXO FOOD SOLUTIONS (I) PVT LTD;0.00;35.00;1946.00;1911.00
20/01/2020 13:00:36;Meal card;1415011338144;SODEXO FOOD SOLUTIONS (I) PVT LTD;0.00;75.00;2021.00;1946.00
20/01/2020 09:53:00;Meal card;1415011321737;SODEXO FOOD SOLUTIONS (I) PVT LTD;0.00;35.00;2056.00;2021.00
20/01/2020 09:43:16;Meal card;1416751408781;SODEXO FOOD SOLUTIONS (I) PVT LTD;0.00;20.00;2076.00;2056.00
16/01/2020 16:40:17;Meal card;1409461040836;SODEXO FOOD SOLUTIONS (I) PVT LTD;0.00;35.00;2111.00;2076.00
16/01/2020 13:02:28;Meal card;141501918858;SODEXO FOOD SOLUTIONS (I) PVT LTD;0.00;75.00;2186.00;2111.00
16/01/2020 09:41:20;Meal card;140950992394;SODEXO FOOD SOLUTIONS (I) PVT LTD;0.00;30.00;2216.00;2186.00
15/01/2020 12:57:55;Meal card;140950874739;SODEXO FOOD SOLUTIONS (I) PVT LTD;0.00;75.00;2291.00;2216.00
15/01/2020 10:00:39;Meal card;141518860820;SODEXO FOOD SOLUTIONS (I) PVT LTD;0.00;35.00;2326.00;2291.00
15/01/2020 09:51:30;Meal card;141501772977;SODEXO FOOD SOLUTIONS (I) PVT LTD;0.00;20.00;2346.00;2326.00
14/01/2020 13:07:47;Meal card;141372731164;SODEXO FOOD SOLUTIONS (I) PVT LTD;0.00;50.00;2396.00;2346.00
14/01/2020 10:02:26;Meal card;141360048877;SODEXO FOOD SOLUTIONS (I) PVT LTD;0.00;20.00;2416.00;2396.00
10/01/2020 17:39:13;Meal card;141087214786;SODEXO FOOD SOLUTIONS (I) PVT LTD;0.00;70.00;2486.00;2416.00
10/01/2020 12:58:46;Meal card;141032258281;SODEXO FOOD SOLUTIONS (I) PVT LTD;0.00;94.00;2580.00;2486.00
10/01/2020 09:48:58;Meal card;141020241344;SODEXO FOOD SOLUTIONS (I) PVT LTD;0.00;20.00;2600.00;2580.00
09/01/2020 13:12:44;Meal card;141088012402;SODEXO FOOD SOLUTIONS (I) PVT LTD;0.00;55.00;2655.00;2600.00
09/01/2020 10:17:14;Meal card;140953068397;SODEXO FOOD SOLUTIONS (I) PVT LTD;0.00;20.00;2675.00;2655.00
08/01/2020 17:33:18;Meal card;140859020274;SODEXO FOOD SOLUTIONS (I) PVT LTD;0.00;35.00;2710.00;2675.00
08/01/2020 17:23:27;Meal card;140429798593;SODEXO FOOD SOLUTIONS (I) PVT LTD;0.00;35.00;2745.00;2710.00
08/01/2020 12:52:22;Meal card;140819745485;SODEXO FOOD SOLUTIONS (I) PVT LTD;0.00;65.00;2810.00;2745.00
08/01/2020 10:21:37;Meal card;140819727586;SODEXO FOOD SOLUTIONS (I) PVT LTD;0.00;20.00;2830.00;2810.00
07/01/2020 13:02:10;Meal card;140428570844;SODEXO FOOD SOLUTIONS (I) PVT LTD;0.00;75.00;2905.00;2830.00
07/01/2020 11:19:42;Meal card;140660053609;SODEXO FOOD SOLUTIONS (I) PVT LTD;0.00;35.00;2940.00;2905.00
06/01/2020 12:59:54;Meal card;140426414785;SODEXO FOOD SOLUTIONS (I) PVT LTD;0.00;75.00;3015.00;2940.00
06/01/2020 10:45:53;Meal card;140518240987;SODEXO FOOD SOLUTIONS (I) PVT LTD;0.00;20.00;3035.00;3015.00
05/01/2020 07:26:51;Meal card;140430304306;CAPGEMINI TECHNOLOGY SERVICES INDIA LTD;2000.00;0.00;1035.00;3035.00
03/01/2020 15:46:25;Meal card;140429096532;SODEXO FOOD SOLUTIONS (I) PVT LTD;0.00;60.00;1095.00;1035.00
03/01/2020 15:31:17;Meal card;140429094808;SODEXO FOOD SOLUTIONS (I) PVT LTD;0.00;30.00;1125.00;1095.00
03/01/2020 13:09:46;Meal card;140426070858;SODEXO FOOD SOLUTIONS (I) PVT LTD;0.00;55.00;1180.00;1125.00
03/01/2020 10:36:58;Meal card;140429051772;SODEXO FOOD SOLUTIONS (I) PVT LTD;0.00;20.00;1200.00;1180.00
02/01/2020 16:55:24;Meal card;140401001937;SODEXO FOOD SOLUTIONS (I) PVT LTD;0.00;30.00;1230.00;1200.00
02/01/2020 13:22:31;Meal card;140268398080;SODEXO FOOD SOLUTIONS (I) PVT LTD;0.00;35.00;1265.00;1230.00
02/01/2020 13:00:00;Meal card;140365900389;SODEXO FOOD SOLUTIONS (I) PVT LTD;0.00;75.00;1340.00;1265.00
02/01/2020 10:39:02;Meal card;140250889249;SODEXO FOOD SOLUTIONS (I) PVT LTD;0.00;25.00;1365.00;1340.00
01/01/2020 15:39:48;Meal card;140328086946;DOMINO'S PIZZA;0.00;569.00;1934.00;1365.00
